24 16 16 1 16 16 16 1 16 16 16 16 16 1 1 1
24 16 16 1 2 1 1 1 1 16 16 16 16 16 1 1
30 22 16 1 1 1 1 1 1 16 16 16 16 16 1 1
18 24 16 1 1 1 2 1 1 16 16 16 16 16 1 1
18 24 16 16 16 16 16 16 16 16 16 16 16 16 1 1 
18 24 16 16 16 16 16 16 16 16 16 16 16 16 1 1
28 27 16 33 16 16 16 16 16 16 16 16 16 16 1 1
24 16 16 1 16 16 1 1 16 1 1 1 1 1 1 1 1
24 16 16 1 1 1 2 1 1 1 1 1 1 2 1 1 1
30 21 22 1 1 1 1 1 2 1 20 21 21 22 1 1
18 18 30 21 21 21 21 21 21 21 31 18 18 30 22 1
18 18 18 18 18 18 18 18 18 18 18 18 18 18 30 21