1 1 1 1 1 1 23 18 18 18 18 18 18 18 18 19
1 2 1 1 1 1 25 26 29 18 18 18 18 18 18 18
1 1 1 1 2 1 1 1 23 18 19 18 18 18 18 18
1 1 1 1 1 1 1 1 23 18 18 18 18 18 18 18
1 1 2 1 1 1 1 1 23 18 18 18 18 18 18 18
1 1 1 1 1 1 1 2 23 18 18 19 18 18 18 18
1 1 1 1 2 1 1 1 23 18 18 18 18 18 18 18
1 1 1 1 1 1 1 1 23 18 18 18 18 18 18 18
21 21 21 21 21 21 21 21 31 18 18 18 18 18 18 18
18 18 18 18 18 18 18 18 18 18 18 18 18 18 19 18
18 19 18 18 18 18 18 18 18 18 19 18 18 18 18 18
18 18 18 18 18 18 18 18 18 18 18 18 18 18 18 18