18 18 18 18 18 18 19 18 19 18 18 18 19 18 18 18
26 26 26 26 29 18 18 18 28 26 26 26 26 26 26 26
1 1 1 1 25 26 26 26 27 16 1 2 1 1 1 1 
1 20 21 21 21 22 1 16 16 16 16 16 16 16 1 1
1 23 18 18 18 24 1 16 16 16 16 16 16 16 2 1
1 23 18 18 18 24 1 16 16 16 16 16 16 16 1 1
1 25 26 26 26 27 1 16 16 16 16 16 16 16 1 1
1 12 10 13 1 1 1 1 1 1 2 1 1 1 1 1
1 8 3 7 16 16 16 16 16 16 16 16 16 16 16 16
1 8 3 7 16 16 16 16 16 16 16 16 16 16 16 16
1 8 3 7 16 16 16 16 16 16 16 16 16 16 16 16
1 8 3 7 1 2 1 16 16 16 16 16 16 1 1 1