8 3 7 16 16 16 16 16 16 16 16 16 16 12 10 10
8 3 7 16 16 16 16 16 16 16 16 16 16 8 3 3
8 3 7 1 16 16 16 16 16 16 16 16 16 8 3 4
11 3 9 10 10 10 10 13 16 16 16 1 1 8 3 7 
3 3 3 3 3 3 3 7 1 1 16 12 10 11 3 7
6 3 4 5 5 5 5 15 16 16 1 8 3 3 3 7 
8 3 7 1 16 16 16 16 16 16 16 14 5 6 3 7
8 3 7 16 16 16 16 16 16 16 16 16 16 8 3 7
8 3 7 16 16 16 16 16 16 16 16 16 16 8 3 7
8 3 7 16 16 16 16 1 1 16 16 16 16 8 3 7
8 3 7 1 1 1 16 16 1 1 16 16 16 8 3 7 
8 3 7 16 16 1 16 16 1 1 16 16 16 14 5 15