19 24 1 32 32 36 32 32 1 23 19 18 18 18 18 18
18 24 16 32 32 17 32 32 1 23 18 28 26 26 26 26
18 24 16 32 32 17 32 32 16 25 26 27 16 1 1 1
18 24 16 32 17 17 17 32 16 16 16 16 16 16 16 1
18 24 16 32 17 17 17 32 16 16 16 16 16 16 16 1
18 24 16 32 17 17 17 32 16 16 16 16 16 16 16 1
18 24 16 32 17 17 17 32 16 16 16 16 16 16 16 1
19 24 16 32 32 17 32 32 16 16 16 16 16 16 16 1
18 24 16 16 16 1 16 16 16 16 16 16 16 16 16 1
18 30 22 16 16 1 16 16 16 16 16 16 16 16 16 1
19 18 24 16 16 1 16 16 16 16 16 16 16 16 16 1
18 28 27 16 16 1 16 16 16 16 16 16 16 16 16 1