1 1 8 3 3 3 3 3 7 23 18 18 19 18 18 18
10 10 11 3 3 3 3 3 7 23 18 18 18 18 18 18
3 3 3 3 3 3 3 3 7 23 18 18 18 18 19 18
5 5 5 5 5 5 5 5 15 23 18 18 18 18 18 18
2 1 1 1 1 20 21 21 21 31 18 18 18 19 18 18 18 18
1 1 1 1 1 23 18 18 18 18 18 18 18 18 18 18 18 
1 1 1 1 1 23 19 18 18 19 18 18 18 18 18 18 18 
1 2 1 1 1 23 18 18 18 18 18 18 18 18 18 18 18
1 1 1 2 1 23 18 18 18 18 18 18 18 18 18 18 18
1 1 1 1 1 23 18 18 18 18 19 18 18 18 18 18 19
1 1 2 1 1 23 18 18 18 18 18 18 18 18 18 18 18
1 1 1 1 1 23 18 18 18 18 18 18 18 18 18 18 18