18 18 18 18 18 19 18 18 18 18 18 18 19 18 18 19
26 26 26 26 26 26 26 26 26 26 26 26 29 18 18 18
12 10 10 10 10 10 10 10 10 10 10 13 23 19 18 18
8 3 3 3 3 3 3 3 3 3 3 7 23 18 18 18
8 3 3 3 3 3 3 3 3 3 3 7 23 18 18 19
8 3 3 3 3 3 3 3 3 3 3 7 23 19 18 18
8 3 3 3 3 3 3 3 3 3 3 7 23 18 18 18
14 5 6 3 3 3 3 3 3 4 5 15 23 18 18 18
16 1 8 3 3 3 3 3 7 20 21 21 31 18 18 18 19
16 1 8 3 3 3 3 3 7 23 18 18 18 18 18 18 18
16 16 8 3 3 3 3 3 7 23 19 18 18 18 18 18
16 16 8 3 3 3 3 3 7 23 18 18 19 18 18 18