8 3 7 16 16 1 16 16 1 1 16 16 16 1 1 1
8 3 7 16 16 1 16 16 1 1 16 16 1 1 1 1
8 3 7 16 16 1 1 1 1 1 16 16 16 1 1 1
8 3 7 16 16 16 16 16 16 16 16 16 1 1 1 1
14 5 15 16 16 16 16 16 16 16 16 16 16 16 16 1
1 1 1 1 16 16 16 16 16 16 16 1 1 1 1 1 
2 1 1 1 1 16 16 1 16 16 1 1 2 1 1 1
1 1 1 1 1 16 16 16 16 1 1 16 1 1 1 1
1 1 1 1 1 1 1 1 1 1 1 20 21 21 21 21
1 1 1 1 1 1 1 1 1 1 20 31 18 18 18 18
1 1 20 21 21 21 21 21 21 21 31 18 18 18 18 18
21 21 31 18 18 18 18 18 18 18 18 18 19 18 18 18