28 27 16 16 16 1 16 16 16 16 16 16 16 16 16 1
24 16 16 1 1 1 16 16 16 16 16 16 16 16 16 1
24 16 16 1 16 16 16 16 16 16 16 16 16 16 1 1
24 16 16 1 16 16 1 12 10 10 10 10 10 10 10 10
24 16 16 1 16 16 1 8 3 3 3 3 3 3 3 3
24 16 16 2 16 16 1 14 5 5 5 5 5 5 5 5
30 22 16 1 16 16 1 16 16 16 16 16 16 16 1 1
18 24 16 1 16 16 1 16 16 16 16 16 16 16 1 1
18 27 16 1 16 16 1 1 16 16 16 16 16 16 1 1
24 16 16 2 16 16 16 1 16 16 16 16 16 16 1 1
24 16 16 1 16 16 16 2 16 16 16 16 16 16 1 1
24 16 16 1 16 16 16 1 16 16 16 16 16 16 1 1