38 38 38 38 38 38 38 38 38 38 38 38 38 38 38 38
38 39 39 39 39 39 39 39 39 39 39 39 39 39 39 38
38 39 39 39 39 39 39 39 39 39 39 39 39 39 39 38
38 39 39 39 39 39 39 39 39 39 39 39 39 39 39 38
38 39 39 39 39 39 39 39 39 39 39 39 39 39 39 38
38 39 39 39 39 39 39 39 39 39 39 39 39 39 39 38
38 39 39 39 39 39 39 39 39 39 39 39 39 39 39 38
38 39 39 39 39 39 39 39 39 39 39 39 39 39 39 38
38 39 39 39 39 42 39 39 39 39 39 39 39 39 39 38
38 39 39 39 42 41 42 39 39 39 39 39 39 39 39 38
38 39 39 42 41 41 41 42 39 39 39 39 39 39 39 38
38 38 38 38 38 37 38 38 38 38 38 38 38 38 38 38